1, 3, 2, 4, 4, 2, 2, 2, 2, 2,
3, 3, 4, 4, 3, 3, 5, 0, 3, 2,
5, 5, 4, 3, 3, 3, 5, 3, 3, 2,
2, 3, 3, 2, 2, 2, 5, 3, 2, 2,
2, 5, 3, 0, 4, 4, 4, 4, 2, 2,
3, 5, 3, 3, 3, 3, 3, 3, 2, 2,
4, 2, 3, 4, 2, 2, 0, 2, 2, 2,
4, 2, 3, 5, 5, 3, 3, 2, 2, 2,
2, 4, 3, 4, 3, 3, 3, 3, 3, 2,
2, 4, 4, 3, 3, 3, 2, 2, 2, 2,